NO ./textures/north_wall.xpm
SO ./textures/south_wall.xpm
WE ./textures/west_wall.xpm
EA ./textures/east_wall.xpm

F 127,125,119
C 174,234,255

11111111111111111111111111111
10000000001100000000011100001
10000000000000000000000000001
100000N0000000000000000000001
10000000000000000000000000001
10000000000000001100000010001
10000000000000001101010010001
11000001110101011111011111111
11110111 1110101 101111010001
11111111 1111111 111111111111
