NO textures/north_wall.xpm
SO textures/south_wall.xpm
WE textures/west_wall.xpm
EA textures/east_wall.xpm

F 127,125,119
C 174,234,255

        1111111111111111111111111
        1000000000110000000000001
        1011000001110000000000001
        1001000000000000000000001
111111111011000001110000000000001
100000000011000000000111000000001
111101111111110111000000100011111
11110111111111011101010010001
11000000110101011100000010001
10000000000000001100000010001
10000000000000001101010010001
11000001110101011111011110N0111
11110111 1110101 101111010001
11111111 1111111 111111111111
